# Correzioni personalizzate per errori comuni italiani
# Formato: errore_comune → correzione_corretta

# Errori specifici rilevati
bottaga → bottega
bottaia → bottega
vlta → volta
alta → volta
sugu → sugo
suga → suga
fato → fatto
go → ho
cassella → casella
milliore → migliore
carezzzzavano → carezzavano
ansiano → anziano
borggo → borgo
strignendo → stringendo
trasformazzione → trasformazione
CAPTIOLO → CAPITOLO
Captiolo → Capitolo
Qvesta → Questa
qvesta → questa
duee → due
prontal → pronta
Acondroplasiaaa → Acondroplasia
c erano → c'erano

# Altri errori comuni italiani
pò → po'
qual'è → qual è
un'uomo → un uomo
la cane → il cane
La cane → Il cane
o fatto → ho fatto
a detto → ha detto
fallegname → falegname
d'avero → davvero
sopratutto → soprattutto
accelerare → accelerare
acelerare → accelerare
