
# Altri errori comuni italiani
# Correzioni personalizzate per errori comuni italiani
# Errori specifici rilevati
# Formato: errore_comune → correzione_corretta
Acondroplasiaaa → Acondroplasia
CAPTIOLO → CAPITOLO
Captiolo → Capitolo
La cane → Il cane
Qvesta → Questa
a detto → ha detto
accelerare → accelerare
acelerare → accelerare
alta → volta
ansiano → anziano
borggo → borgo
bottaga → bottega
bottaia → bottega
c erano → c'erano
carezzzzavano → carezzavano
cassella → casella
d'avero → davvero
duee → due
fallegname → falegname
fato → fatto
go → ho
la cane → il cane
milliore → migliore
o fatto → ho fatto
prontal → pronta
pò → po'
qual'è → qual è
qvesta → questa
sopratutto → soprattutto
strignendo → stringendo
suga → suga
sugu → sugo
trasformazzione → trasformazione
un'uomo → un uomo
vlta -> volta
vlta → volta
